222222222222222222222222222222222222222222222
222222222222222222222222222222222222222222222
220000000444400000004444000000003333000000022
220000000444400000004444000000003333000000022
220044441144441333311111113333111111144444022
220044441144441333300111113333111410044444022
220044441144441333300111113333111410044444022
220044441144441333311111113333111111144444022
220000000000000444444444444440000000000000022
224400001111100444444444444440000000000000022
224400001444100111111111111110011110011111022
220011001444100100114441110010033330014441022
220011001444100100114441110010011110014441022
220011001444100111111111111110044440014441022
220011001111100000044444440000011110014441022
220033300000000000044444440000033330011111022
220033304400044444444444444444011110443333022
220033304400044444444444444444044440443333022
220033304444033333333333333344011110443333022
224411004444000000000000000044000004400000022
224411004444001100111001110011044004400000022
224411004400001100111001110011044444400000022
220011000000111111133333311111110444400000022
220000010000111111113333111111110444401004422
220000131000444111111331111114440440014104422
220001343100444001444444100004440440143410022
220013444310444001444444100004440441433341022
220001343100444111444444111114440440143410022
220000131000111111444444111111110440014100022
224400010000110010011111001110010440001000022
224400444000110010011111001110010440044400022
224400444000111444444444444441110440044400022
224400444000000011000000000000000440044400022
224411441110000011011111110011000011114411022
220011440010000044011111110011000010014411022
220011440010000044011666110011000010014411022
220011441110000000011666110000000011114411022
220011440000000000011666110000000000004400022
222222222222222222222222222222222222222222222
222222222222222222222222222222222222222222222
