222222222222222222222222222222222222222222222
222222222222222222222222222222222222222222222
221444011114444440011001100444444111104441122
221444011114444440011001100444444111104441122
220033000440000001100000004400000000003300022
220033000440033001100000004400330011003300022
221111100000033004444444444000330000011111022
221111111100000004444444444000000111011110022
220111011110440011111111111104401111111111022
220000000000440114444444444114400444000000022
220000010440001110000000000111000444000000022
220000400440011100000000000011100400040000022
224000400000111004444004444001110444044404422
224010401001110044444004444400111044044404422
223000400011100441111001111440011100040003322
223000000111004411111111111144001110000103322
223044001110044113131313131314400111000003322
223044011100441110011001110011440011144443322
220000001110044113131313331314400111044440022
220000044111004411111111111144001110000000022
221001144011100441001100111440011100011001122
221101100001110044444004444400111440011101122
221133300000111004444004444001110440033003322
221001101040011100003333300011100000011001122
221001133040001110000000000111000103311011122
220000033040100111111111111110004003300440022
220010000040000011111111111100444000000440022
220000104400440004444000444400444044000000022
224444404400440004444000444400004044044444022
224444404444444010004444400104444444044444022
224444404444444000004444400004444444044444022
221111101111111041111111111101111111011111022
221111101111111041444444440001111111011111022
220000000000000041011111110100000000000000022
221111111334411140011111110011144331111111122
221111111334433100011666110013344331111111122
223444411004411100011666110010044001144443322
223444411334411100011666110011144331144443322
222222222222222222222222222222222222222222222
222222222222222222222222222222222222222222222
