2222222222222222222222222222222222222222222222222222222222
2222222222222222222222222222222222222222222222222222222222
2200000000000000000000000000000000000000000000000000000022
2200000000000000000000000000000000000000000000000000000022
2200111100111100000000111100000011110000000011110011110022
2200111100111100000000111100000011110000000011110011110022
2200111100111144444444111100000011114444444411110011110022
2200111100111144444444111100000011114444444411110011110022
2200111100111144444444111133333311114444444411110011110022
2200111100111144444444111133333311114444444411110011110022
2200111100111144444444111133333311114444444411110011110022
2200111100111144444444111133333311114444444411110011110022
2200111100111144444444111133333311114444444411110011110022
2200111100111144444444111133333311114444444411110011110022
2200111100111100000000111100000011110000000011110011110022
2200111100111100000000111100000011110000000011110011110022
2200111100111100000000111100000011110000000011110011110022
2200111100111100000000111100000011110000000011110011110022
2200111100111100000000000000000000000000000011110011110022
2200000000000000000000000000000000000000000000000000000022
2200000000000000000000111144444411110000000000000000000022
2211111100111111111100111144444411110011111111110011111122
2211111100111111111100111144444411110011111111110011111122
2233333300111111111100111144444411110011111111110033333322
2233333300111111111100111144444411110011111111110033333322
2200000000000000000000111144444411110000000000000000000022
2200000000000000000000111144444411110000000000000000000022
2200001111000011110000111144444411110000111100001111000022
2200001111000011110000111111111111110000111100001111000022
2200001111000011110000111111111111110000111100001111000022
2200001111000011110000111111111111110000111100001111000022
2200001111000011110000111111111111110000111100001111000022
2200001111000011110000111100000011110000111100001111000022
2200001111000011110000111100000011110000111100001111000022
2200001111000011110000111100000011110000111100001111000022
2200001111000011110000111100000011110000111100001111000022
2200001111000011110000000000000000000000111100001111000022
2200001111000011110000000000000000000000111100001111000022
2200001111000011110000000111111110000000111100001111000022
2200001111000011110000000111111110000000111100001111000022
2200001111000011110000000116666110000000111100001111000022
2200001111000011110000000116666110000000111100001111000022
2200000000000000000000000116666110000000000000000000000022
2200000000000000000000000116666110000000000000000000000022
2222222222222222222222222222222222222222222222222222222222
2222222222222222222222222222222222222222222222222222222222
