222222222222222222222222222222222222222222222
222222222222222222222222222222222222222222222
220000000000000033000000000000000004444400022
220000000000000033000000000000000004444400022
220033444441111444444444444444444444444444422
220033444441111444444444444444444444444444422
224411111400000011111111111111111111111100022
224411111400000011111111111111111111111100022
224444444400001111144444444411111111111110022
224444444400001111144444444411111144444410022
224444000000111111111111111111111144444410022
224444000000111111111111111111111111111110022
224444000011111111000000000000000000111110022
224444000011111111000000000000000000111110022
223334000011000001111000000001111000000110022
223334000011000001111000000001111000000110022
220000000011000000000111111100000000000110022
220000000011000000000111111100000000000110022
220000000011000000000444444400000000000110022
220000000011000000000444444400000000000110022
224444000011011110000111111100000000000110022
224444000011011110000111111100000000000110022
224444001111111111111111111111111111111110022
224444001111111111111111111111111111111110022
220000001111000000011111111111111111111110022
220000001111000000011444444411111111111110022
220000111111000000011444444411111111111110022
220000111111111111111111111111111331111110022
220000000001111111111111111111111331111000022
220000000001111111111111111111111331111000022
220000111101111004444400000000000330000000022
220000111101111004444400000000000000000000022
220000111101111000111111110000000000000000022
220000111101111000111111110000044440001111022
220000000000000000116666110000044440001111022
220000000000000000116666110000000000001111022
224444000000333300116666110033330000001111022
224444000000333300116666110033330000000333322
222222222222222222222222222222222222222222222
222222222222222222222222222222222222222222222
