2222222222222222222222222222222222222222222222222222222
2222222222222222222222222222222222222222222222222222222
2200000000000000000000000000000000000000000000000000022
2200000000000000000000000000000000000000000000000000022
2200334444444444444444444444444444444444444444444443322
2200334444444444444444444444444444444444444444444443322
2244444444000000111111111111111111111111000000000000422
2244444444000000111111111111111111111111000000000000422
2244444444000011111111111111111111111111111100000000422
2244444444000011111111111111111111111111111100000000422
2244440000001111111111111111111111111111111111111100322
2244440000001111111111111111111111111111111111111100322
2244440000111111110000000000000000001111111111111100022
2244440000111111110000000000000000001111111111111100022
2233330000110000011110000000011110000001111111100000022
2233330000110000011110000000011110000001111111100000022
2200000000110003300001111111000000330001111111111000022
2200000000110003300001111111000000330001111110000000022
2200000000110003300004444444000000330001111110000000022
2200000000110003300004444444000000330001111110004444422
2244440000110111100001111111000000000001111110004444422
2244440000110111100001111111000000000001111110004444422
2244440011111111111111111111111111111111111110004444422
2244440011111111111111111111111111111111111110000000022
2200000011111111111111111111111111111111111110000000022
2200000011111111111111111111111111111111111111111100022
2200001111111111111111111111111111111111111111110000022
2200001111111111111111111111111111111111111111110000022
2200000000011111111111111111111111111110000000000011122
2200000000011111111111111111111111111110000000000011122
2200001111011110000111111111111111100000000000000011122
2200001111011110000111111111111111100000000000000011122
2200001111011110000000011111111100000000000000000000422
2200001111011110000111111111111100000011110000000000422
2200000000000000000111100001111100000011110000000000422
2200000000000000000000000000000000000011110000000000422
2244440000000333300000000000000000000011110000004444422
2244440000000333300000011111111000000000000000004444422
2244440000000000000000011111111000000000000033334444422
2244440000000000000000011666611000000000000033334444422
2233334444444444444400011666611000044440000044444444322
2233334444444444444400011666611000044440000044444444322
2233334444444444444400011666611000044440000044444444322
2222222222222222222222222222222222222222222222222222222
2222222222222222222222222222222222222222222222222222222
