2222222222222222222222222222222222222222222222222222222222
2222222222222222222222222222222222222222222222222222222222
2200000000000000000000000000000000000000000000000000000022
2200000000000000000000000000000000000000000000000000000022
2200334444444444444444444444444444444444444444444444330022
2200334444444444444444444444444444444444444444444444330022
2244444444000000111111111111111111111111000000000000444422
2244444444000000111111111111111111111111000000000000444422
2244444444000011111111111111111111111111111100000000444422
2244444444000011111111111111111111111111111100000000444422
2244440000001111111111111111111111111111111111111100333322
2244440000001111111111111111111111111111111111111100333322
2244440000111111110000000000000000001111111111111100000022
2244440000111111110000000000000000001111111111111100000022
2233330000110000000000000000011110000001111111100000000022
2233330000110000000000000000011110000001111111100000000022
2200000000110003300001111111000000330001111111111000000022
2200000000110003300001111111000000330001111110000000000022
2200000000110003300000000000000000330001111110000000000022
2200000000110003300000000000000000330001111110004444444422
2244440000110111100001111111000000000001111110004444444422
2244440000110111100001111111000000000001111110004444444422
2244440011111111111111111111111111111111111110004444444422
2244440011111111111111111111111111111111111110000000000022
2200000011111111111111111111111111111111111110000000000022
2200000011111111111111111111111111111111111111111100000022
2200001111111111111111111111111111111111111111110000000022
2200001111111111111111111111111111111111111111110000000022
2200000000011111111111111111111111111110000000000000111122
2200000000011111111111111111111111111110000000000000111122
2200001111011110000111111111111111100000000000000000000022
2200001111011110000111111111111111100000000000000000000022
2200001111011110000000011111111000000000000000000000444422
2200001111011110000000011111111000000000003333000000444422
2200000000000000000000011111111000000000003333000000444422
2200000000000000000000011111111000000011110000000000444422
2244440000000333300000000000000000000011110000004444444422
2244440000000333300000000000000000000011110000004444444422
2244440000000000000000000111111110000011110000004444444422
2244440000000000000000000111111110000000000000004444444422
2233334444444444444400000116666110044440000044444444333322
2233334444444444444400000116666110044440000044444444333322
2233334444444444444400000116666110044440000044444444333322
2233334444444444444400000116666110044440000044444444333322
2222222222222222222222222222222222222222222222222222222222
2222222222222222222222222222222222222222222222222222222222
