2222222222222222222222222222222222222222222222222222222222
2222222222222222222222222222222222222222222222222222222222
2200000000000444444400000000000000000044444440000000000022
2200000000000444444400000000000000000044444440000000000022
2244441111111111111110000000000000000111111111111111444422
2244441111111111111110000000000000000111111111111111444422
2244441111111111111110000000000000000111111111111111444422
2244441111111111111110000333333330000111111111111111444422
2244441111100444444444444333333334444444444440011111444422
2244441111100444444444444000000004444444444440011111444422
2244441111100444444444444000000004444444444440011111444422
2200001111144444444444444411111144444444444444411111000022
2200001111144444444444444411111144444444444444411111000022
2200001111144444444444444411111144444444444444411111000022
2200001111144444444444444411111144444444444444411111000022
2200001111144444444000111111111111110004444444411111000022
2200001111144444444000111111111111110004444444411111000022
2233333000044444444000111111111111110004444444400003333322
2233333000044444444000111111111111110004444444400003333322
2233333000044444444000000011111100000004444444400003333322
2233333000044444444000000011111100000004444444400003333322
2200001111144444444000000011111100000004444444411111000022
2200001111144444444000000011111100000004444444411111000022
2200001111144444444000000333333330000004444444411111000022
2200001111144444444000000333333330000004444444411111000022
2244441111111111111114444444444444444111111111111111444422
2244441111111111111114444444444444444111111111111111444422
2244441111111111111114444444444444444111111111111111444422
2244441111111111111110000000000000000111111111111111444422
2244440000000000000000000333333330000000000000000000444422
2244440000000044444444000333333330004444444400000000444422
2244440000000044444444000333333330004444444400000000444422
2244443333333344444444000333333330004444444433333333444422
2244443333333344444444000000000000004444444433333333444422
2244443333333344444444000000000000004444444433333333444422
2244443333333344444444000000000000004444444433333333444422
2211111000333344444444000000000000004444444433330001111122
2211111000333344444444000000000000004444444433330001111122
2211111000333344444444000111111110004444444433330001111122
2211111000333344444444000111111110004444444433330001111122
2211111000333344444444000116666110004444444433330001111122
2211111000333344444444000116666110004444444433330001111122
2211111000333344444444000116666110004444444433330001111122
2211111000333344444444000116666110004444444433330001111122
2222222222222222222222222222222222222222222222222222222222
2222222222222222222222222222222222222222222222222222222222