2222222222222222222222222222222222222222222222222222222222
2222222222222222222222222222222222222222222222222222222222
2200114440000111114444440011001100444444111110000444110022
2200114440000111114444440011001100444444111110000444110022
2200000330000000000000000000000000000000000000000330000022
2200000330000000000033000000000000000330000000000330000022
2200011111100000000033004444444444000330000000011111100022
2200011111100011110000004444444444000000111100011111100022
2200011111100011110000011111111111100000111100011111100022
2200000000000000000000111111111111110000000000000000000022
2200000000000000000001110000000000111000000000000000000022
2200000004444000000011100000000000011100000004444000000022
2244440004334000000111004444444444001110000004334000444422
2244440004334000001110044444444444400111000004334000444422
2233330004444000011100441111111111440011100004444000333322
2233330000000000111004411111111111144001110000000000333322
2233330000000001110044113131313331314400111000000000333322
2233330000000011100441113331313331311440011100000000333322
2200000000000001110044113131313331314400111000000000000022
2200000000000000111004411111111111144001110000000000000022
2200110011000000011100441111111111440011100000001100110022
2200110011000000001110044444444444400111000000001100110022
2200333333000000000111004444444444001110000000003333330022
2200110011000000000011100000000000011100000000001100110022
2200110011033333000001110000000000111000003333301100110022
2200000000033333000000111111111111110000003333300000000022
2200000000000000000000011111111111100000000000000000000022
2200000000000000000000004444444444000000000000000000000022
2200044444440000000000004444444444000000000000444444400022
2200044444440004444444000000000000004444444000444444400022
2200044444440004444444000000000000004444444000444444400022
2200011111110001111111000111111110001111111000111111100022
2200011111110001111111000444444440001111111000111111100022
2200033333330003333333000444444440003333333000333333300022
2200033333330003333333000333333330003333333000333333300022
2200000000000000000000000333333330000000000000000000000022
2200000000000000000000000000000000000000000000000000000022
2200000000000000000000000000000000000000000000000000000022
2211111111111111114400000111111110000044111111111111111122
2211111111111111114411100111111110011144111111111111111122
2211111111111111114433100116666110013344111111111111111122
2233334444444111114433100116666110013344111114444444333322
2233334444444111114411100116666110011144111114444444333322
2233334444444111114400000116666110000044111114444444333322
2222222222222222222222222222222222222222222222222222222222
2222222222222222222222222222222222222222222222222222222222
