2222222222222222222222222222222222222222222222222222222222
2222222222222222222222222222222222222222222222222222222222
2200000000000444444400000000000000000044444444000000000022
2200000000000444444400000000000000000044444444000000000022
2200000000000000000000000000000000000000000000000000000022
2200000000000000000000000000000000000000000000000000000022
2200111133331111111111111110000111111111111111333311110022
2200111133331111111111111110000111111111111111333311110022
2200111111111111111111111110000111111111111111111111110022
2200111111111111111111111110000111111111111111111111110022
2200110004444444444444444000000004444444444444444000110022
2200110004444444444444444000000004444444444444444000110022
2200110004444444444444444000000004444444444444444000110022
2200110004444444444444444000000004444444444444444000110022
2200110004444444444444444001111004444444444444444000110022
2200110000000000003333000001111000003333000000000000110022
2200001100000000003333000001111000003333000000000011000022
2200001100000044444444444441111444444444444400000011000022
2200001100000044444444444441111444444444444400000011000022
2244444411000000003333000001111000003333000000001144444422
2244444411000000003333000001111000003333000000001144444422
2244444411000000000000000001111000000000000000001144444422
2244444400110000000000000000000000000000000000110044444422
2244444400110000000000000000000000000000000000110044444422
2244440000110000000000000000000000000000000000110000444422
2244440000001144444444003333003333004444444411000000444422
2244440000001144444444003333003333004444444411000000444422
2244440000001144444444003333003333004444444411000000444422
2244443333000044444444003333003333004444444400003333444422
2244443333000044444444003333003333004444444400003333444422
2244440000000044444444003333003333004444444400000000444422
2244440000000044444444000000000000004444444400000000444422
2244440000000044444444000000000000004444444400000000444422
2211111111111111133331111000000001111111111111113333111122
2211111111111111133331111000000001111111111111113333111122
2211111111111111111111111000000001111111111111111111111122
2211111111111111111111111000000001111111111111111111111122
2200000000333300000000000000000000000000000033330000000022
2200000000333300000000000111111110000000000033330000000022
2200000000444400000000000111111110000000000044440000000022
2200000000444400000000000116666110000000000044440000000022
2200000000333300000000000116666110000000000033330000000022
2200000000333300000000000116666110000000000033330000000022
2200000000000000000000000116666110000000000000000000000022
2222222222222222222222222222222222222222222222222222222222
2222222222222222222222222222222222222222222222222222222222