2222222222222222222222222222222222222222222222222222222222
2222222222222222222222222222222222222222222222222222222222
2200000000000001111100000000000000000000000000000011000022
2200000000000001111100000000110000000000000000000011000022
2200000000000001111100000000110000000000000000000011000022
2200000000000000000000000000110000000000000000000011000022
2200000000000000000000000001111000000000000000000011000022
2200000000000000000000000011111100000000000000000011000022
2200000000011000000000000011111100000000000001100000000022
2211111444111100000000000011111100000000000011114444444422
2211111444111111111100001111111111000001111133314444444422
2211111444333111111000000111111110000000111111114444444422
2244444444111111100000000111111110000000011111114444444422
2244444444111111111111111111111111111111111113334444444422
2244444444133311111111111111111111111111111111114444444422
2244444444111111111111111111111111111111111111114444444422
2244444444111111111111111111111111111111111133314444444422
2244444444333111100000000000000000000000011111114444444422
2244444444111111000000000000000000000000001111114444444422
2244444444111111000000000000000000000000001113334444444422
2244444444133311004404444440004444400044001111114444444422
2244444444111111004404444440004444400444001111114443333322
2244444444111111004400044000004404404444001133314444444422
2244444444333111004400044000004444400044001111114444444422
2244444444111111004400044000004444400044001111114444444422
2244333344111111004400044000000004400044001113334444444422
2244333344133311004400044000000004400044001111114444444422
2244444444111111004400044000004444400044001111114444444422
2244444444111111004400044000004444400044001133314444444422
2244444444333111000000000000000000000000001111114444444422
2244444444111111100000000000000000000000011111114444444422
2244444444111111111111111111111111111111111113334444444422
2244444444133311111111111111111111111111111111114444444422
2244444444111100111111111111111111111111110011114444444422
2244444444111100011111111111111111111111100033314444444422
2244444444333100000000000000000000000000000011114444444422
2244444444011000000000000000000000000000000001104444444422
2244411144000000000000000003333000000000000000004444444422
2244411144000000000000000111111110000000000000004444444422
2244411144000000000000000111111110000000000000004444444422
2244411144000000000000000116666110000000000000004444444422
2233311144000000000000000116666110000000000000003333334422
2233311144000000000000000116666110000000000000001111114422
2233311144000000000000000116666110000000000000001111114422
2222222222222222222222222222222222222222222222222222222222
2222222222222222222222222222222222222222222222222222222222



