222222222222222222222222222222222222222222222
222222222222222222222222222222222222222222222
220000000033000011000000000000000033000000022
220000000033000011000000000000000033000000022
220000111111111144000000000441111111111000022
223300110011100144004444400441111001111003322
223300110011100144004333400441111001111003322
223300000033344444114313411444444333000003322
224444400033344444114333411444444333004444422
224444400033344444444444444444444333004444422
221110000000044000440111044004400000000111122
220011000044444004400111004400444440000110022
220011100044444004400111004400444440001110022
221111100011114444444004444444111100001111122
220000000011114444444004444444111100440000022
221144001111111111111111111111111100440000022
221144001113311110000000000110013300110000022
220004400013310010000000000110013300114401122
221104400013310013333333333111113304404401122
221104400011111111110000001111100104404404422
224404400000111111110000001111100100000004422
224404400000110044413333314440011100000000022
220004444444000044413333314440000444444400022
220004444444000044413333314440000444444400022
224441144114440111111111111111044411441144422
224411111111440111111111111111044111111114422
220011333311440144114400411441044113333110022
220011300311440144114400411441044113003110022
220041300314440111111111111111044413003140022
220011333311440114444444444411044113333110022
220011111111000114444444444411440111111110022
220041144114000000001111100000440411441140022
220000000000000004444444444400000000000000022
220000000000000000011111110000000000000000022
221111001113331100011111110011113331100111122
221111001113331100011666110011113331100111122
224400114444441100011666110000114444114400422
224400114444441100011666110000114444114400422
222222222222222222222222222222222222222222222
222222222222222222222222222222222222222222222
