222222222222222222222222222222222222222222222
222222222222222222222222222222222222222222222
220000000334440000000000000044440044300000022
220000000334440000000000000044440044300000022
220033000000000000000000000000000000000330022
220033000000000000000000000000000000000330022
224411440000111111111133311111111100044114422
224411440011111144111133311114411111044114422
224400000011111144111133311114411111000004422
224400001111111111111111111111111111100003322
224400011111111111111111111111111111110003322
224400010000000000000000000000000000010004422
220000010000000000000000000000000000010000022
220000010444444004444444444440044444410000022
220000010113311001111111111110011331110000022
220000000113311001111111111110011331100000022
220000000113444444444444444440011331100000022
221111100113444444444444444440011331101111122
224444100113333001111111111110033331101444422
224444100113333001111111111110033331101444422
224444101111111111113333331111111111101444422
224444101111111111111333311111111111101444422
221111101111111444111133111144411111101111122
220000001111111444111111111144411111100000022
220000111111111444111111111144411111111000022
220000111111111444111111111144411111111000022
220000000000000111111111111111110000000000022
220000110000000111111111111111110000011000022
220000110444400111111133111111110044411000022
220000110111100000011333311000000011111000022
220000110111100000013333331000000011111000022
220000440111100000444444444000000011144000022
220000000111100000000000004000000011100000022
221111000333300000011111114000000033300111122
221111000333300000011111114000000033300111122
223334441114444000011666114000044441144433322
223334441114444000011666114000044441144433322
223334441114444000011666114000044441144433322
222222222222222222222222222222222222222222222
222222222222222222222222222222222222222222222
