222222222222222222222222222222222222222222222
222222222222222222222222222222222222222222222
220000000000000000000000000000000000000000022
220000000000000000000000000000000000000000022
220011100111000001111000011110000111001110022
220011100111000001111000011110000111001110022
220011100111444441111000011114444111001110022
220011100111444441111000011114444111001110022
220011100111444441111333311114444111001110022
220011100111444441111333311114444111001110022
220013333331444441111333311114444111001110022
220013333331444441111333311114444133333310022
220011100111444441111333311114444133333310022
220011100111444441111333311114444111001110022
220011100111000001111000011110000111001110022
220011100111000001111000011110000111001110022
220011100111000004444444444440000111001110022
220011100111000004444444444440000111001110022
220011100111000000000333300000000111001110022
220000000000000000000333300000000000000000022
221111100111111000000000000000111111001111122
221133300111111000000000000000111111003331122
221133300111111011114444111100111111003331122
220000000000000011114444111100000000000000022
220000000000000011114444111100000000000000022
220001111444110011114444111100111444111100022
220001111444110011111111111100111444111100022
220001111444110011111111111100111444111100022
220001111444110011111111111100111444111100022
220001111444110011111111111100111444111100022
220001111444110011114444111100111444111100022
220001111444110014444444444100111444111100022
220001111444110014444444444100111444111100022
220001111444110014011111114100111444111100022
220001111444110000011111110000111444111100022
220001111444110000011666110000111444111100022
220001111111110000011666110000111111111100022
220001111111110000011666110000111111111100022
222222222222222222222222222222222222222222222
222222222222222222222222222222222222222222222
