222222222222222222222222222222222222222222222
222222222222222222222222222222222222222222222
220000000444400000004444000000003333000000022
220000000444400000004444000000003333000000022
220044441111111333311111113333111111144444422
220044441144111333311111113333114411144444422
220044441144111333311111113333114411144444422
220044441111111333311111113333111111144444422
220440000000004400004444000000000444000440022
220440001111104400004444000000000444000440022
220000001444100110011002200110011110000000022
220111001444100110011002200110033330044411122
220111001444144114411442244114411110044411122
220111001444144114411442244114444440044411122
220111001111100000000000000004411110044411122
220033330000004444444444444404433330003333022
220033330000004444444444444400011110003333022
224433331111000000000000000000044440003333022
224433331441033033334433033344011110003333022
220011001441000000444400000044000000440011122
220011001111000000440000000000000000440011122
220011000440111100111101111001111000000011122
224411000440111100111101111001111044000011122
224400010440110440001101100440011044001000022
220000131440110440001101100440011440014100022
224401303100110033001101100330011440140410022
224413000310110033001101100330011001400041022
220001303100110444401101104444011000140410022
220000131000110444401101104444011440014104422
220440010000110444401101104444011440001004422
220440000000110444401101104444011000000000022
220000000044000000000000000004400033000000022
220000000044000444000000004004400033000000022
220011441100111444011111114440003300114411022
220011441100111400011111114440003300114411122
220011441100133400011666114440003300114411122
220011441100133400011666114440003300114411122
220011441100111400011666114440000000114411122
222222222222222222222222222222222222222222222
222222222222222222222222222222222222222222222
