222222222222222222222222222222222222222222222
222222222222222222222222222222222222222222222
220000000000000033000000000000000004444400022
220000000000000033000000000000000004444400022
220033444441110044444444400044444441111144422
220033444441110044444444400044444441111144422
224411111400000011111111111113311111111100022
224411111400000011111111111113311111111100022
224444444400001111144444444413311111111110022
224444444400001111144444444413311144444410022
220000000000111111111111111111111144444410022
220000000000111111111111111111111111111110022
224444330011111111000004444440000000111113322
224444330011111111000004334440000000111113322
224433330011000001111004334441111000000113322
224433330011004441111004333331111000000113322
220000000011004111144004333330000000000110022
220000000011004111144004111140000044444110022
220000000011004111144444111140000044444110022
220000000011004111144444111140000011111110022
221111000011011110000111111100000014444110022
221111000011011110000111111100000014444110022
221111001133111111111111111111111111331110022
221111001133111111111111111111111111331144422
220000003333000000033111111111111111331144422
220000003333000000033444444444411111331144422
220000111111000000033444444444411111111144422
220000111111111111133111111133333331111110022
220000000001111111111111111133333331111000022
220000000001111111111111111111111331111000022
220000111001111004444400000000000330000000022
224444111001111004444400000000000000000000022
224444111001111000000000000000000000000000022
224444111001111000011111110000044440001111022
224444000000000000011111110000044440001111022
220000000000000000011666110000000000001111022
224444000000333300011666110033330000001111022
224444000000333300011666110033330000000333322
222222222222222222222222222222222222222222222
222222222222222222222222222222222222222222222
