222222222222222222222222222222222222222222222
222222222222222222222222222222222222222222222
220000000000000033000000000000000004444400022
220000000000000033000000000000000004444400022
220033444441110444444444444444444444444444422
220033444441111444444444444444444444444444422
224411111400000011111111111111111111111100022
224411111400000011111111111111111111111100022
224444444400001111144444444411111111111110022
224444444400001111144444444411111144444410022
224444000000111111111111111111111144444410022
224444330000111111111111111111111111111110022
224444330011111111000004444440000000111113322
224444330011111111000004334440000000111113322
223334330011000001111004334441111000000113322
223334000011044441111004334441111000000113322
220000000011044444444004334440000000000110022
220000000011044444444004444440444444444110022
220000000011004444444444444400444444444110022
220000000011004444444444444400444444444110022
224444000011011110000111111100444444444110022
224444000011011110000111111100444444444110022
224444001133111111111111111111111111111110022
224444001133111111111111111111111111111110022
220000001133000000011111111111111111111110022
220000001133000000011444444411111111111110022
220000111111000000011444444411111111111110022
220000111111111111111111111111111331111110022
220000000001111111111111111111111331111000022
220000000001111111111111111111111331111000022
220000111101111004444400000000000330000000022
224444111101111004444400000000000000000000022
224444111101111000000000000000000000000000022
224444111101111000011111110000044440001111022
224444000000000000011111110000044440001111022
220000000000000000011666110000000000001111022
224444000000333300011666110033330000001111022
224444000000333300011666110033330000000333322
222222222222222222222222222222222222222222222
222222222222222222222222222222222222222222222
