222222222222222222222222222222222222222222222
222222222222222222222222222222222222222222222
220000000000000000000000000000000000000000022
220000000000000000000000000000000000000000022
220011111000111110000000000000000000000000022
220011111000111110000000001111100000001111122
220011111000111110000000001111101111101111122
220011111000111110111110001111101111101111122
220011111000111110111110001111101111100000022
220000000000000000111110001111101111100000022
220000001111100000111110000000001111100000022
220000001111100000111110000000001111100000022
220000001111100000111110000000001111100000022
220000001111100000111110011111000000000000022
220000001111100000111110011111000000000000022
220000001111100000111110011111001111100000022
220000001111100000111110011111001111101111122
220000001111100000111110011111001111101111122
221111101111100000111110011111001111101111122
221111101111100000111110011111001111101111122
221111101111100000111110011111001111101111122
221111101111100000111110011111001111100000022
221111100000000000000000011111001111100000022
220000001111100011111000011111001111100000022
220000001111100011111000011111001111100000022
220000001111100011111000011111000000000000022
220000001111100011111000011111001111100000022
220000001111100011111000011111001111100000022
220000001111111111000000000000001111100000022
220000001111111111000000000111111111100000022
220000001111111111000000000111111111100000022
220000001111111111000000000111111111100000022
220000000000000000000000000111111111100000022
220111110001111100011111110000111110011111022
220111110001111100011111110000111110011111022
220111110001111100011666110000111110011111022
220111110001111100011666110000111110011111022
220000000001111100011666110000111110000000022
222222222222222222222222222222222222222222222
222222222222222222222222222222222222222222222
