2222222222222222222222222222222222222222222222222222222222
2222222222222222222222222222222222222222222222222222222222
2200000000000033000000000000000000000000033000000000000022
2200000000000033000000000000000000000000033000000000000022
2200000000111111111111144000000004411111111111110000000022
2200033300111111111111144004444004411111111111110033300022
2200033300111111111111144004334004411111111111110033300022
2200033300000033344444444004334004444444333000000033300022
2200000000000033344444444004334004444444333000000000000022
2200000000000033344444444004444004444444333000000000000022
2200111111100000000000000000000000000000000000011111110022
2200111111100000000000000000000000000000000000011111110022
2200111111100000000000000000000000000000000000011111110022
2200111111100011110004444444444444444000111100011111110022
2200000000000011110004444444444444444000111100000000000022
2200000000000011110001111111111111111000111100000000000022
2233330000000013310001111111111111111000133100000000333322
2233330004400013310001113333333333111000133100044000333322
2233330004400013310001113333333333111000133100044000333322
2233330004400011110001111111111111111000111100044000333322
2244400004400011110001111111111111111000111100044000044422
2244400004400011110000044433333344400000111100044000044422
2244400004400000000000044433333344400000000000044000044422
2244400004400000000000044433333344400000000000044000044422
2244400004444444000000044433333344400000004444444000044422
2244400004444444000000044433333344400000004444444000044422
2244400011111111000001111111111111111000001111111100044422
2244400011111111000001111111111111111000001111111100044422
2244400011333311000001111111111111111000001133331100044422
2244400011333311000001111111111111111000001133331100044422
2244400011333311000001111111111111111000001133331100044422
2233300011333311000000004444444444000000001133331100033322
2233300011111111000000004444444444000000001111111100033322
2233300011111111000000000001111000000000001111111100033322
2211100000000000000000000001111000000000000000000000011122
2211100000000000000000000000000000000000000000000000011122
2211100000000000000000000000000000000000000000000000011122
2211111111111113333111000000000000001113333111111111111122
2211111111111113333111000111111110001113333111111111111122
2211111111111113333111000111111110001113333111111111111122
2211111111111113333111000116666110001113333111111111111122
2233344444444444444111000116666110001114444444444444433322
2233344444444444444111000116666110001114444444444444433322
2233344444444444444111000116666110001114444444444444433322
2222222222222222222222222222222222222222222222222222222222
2222222222222222222222222222222222222222222222222222222222
