222222222222222222222222222222222222222222222
222222222222222222222222222222222222222222222
220000000044400000000000000004444400000000022
220000000044400000000000000004444400000000022
224444111111111100000000000011111111111444422
224444114400133100000000000014413314411444422
224444114400133100003333300014413314411444422
224444110011111100003333300011111110011444422
224444110044444444444000444444444440011444422
220000441144444444444111444444444441144000022
220000441144114444444111444444441141144000022
220000110044114444444111444444441140011000022
220000110044444444444111444444444440011000022
220000144144411000111000111000114441441000022
220000144144411000111000111000114441441000022
220013300011444000111111111000444110003311322
220013300011444000000444000000444110003311322
220013300044114000000444000000411440003311322
220013300044114000000111000000411440003311322
220000111144444000000111000000444441111000022
220000111144411000000111000000114441111000022
220000100144411000000333000000114441001000022
220000100144444011000333000110444441001000022
224444111111111111444444444111111111111444422
224444111111111111444444444111111111111444422
224114000000000000000333000000000000000411422
224114000004444440000333000444444400000411422
224444000334444444444444444444444433000444422
224444000334411444444000444441144433000444422
224444000334411444444000444441144433000444422
220011100111144444444444444444441111000110022
220011100111144440000000000444441111000110022
221110000334411440000000000441144433000011122
220010000334411440011111110441144433000010022
220010000334400440011111110440044433000010022
224440000334400440011666110440044433000044422
224441100114444440011666110444444411001144422
224441100114444440011666110444444411001144422
222222222222222222222222222222222222222222222
222222222222222222222222222222222222222222222

