222222222222222222222222222222222222222222222
222222222222222222222222222222222222222222222
221444011114444440011001100444444111104441122
221444011114444440011001100444444111104441122
220033000440000001100000004400000000003300022
220033000440033001100000004400330000003300022
221441111000033004444444444000330011111441022
221441111000000004444444444000000011111441022
220000000000000011111111111100000000000000022
220044444440000114444444444110000444000000022
220044444440001110000000000111000444000000022
220044444440011100000000000011100444444400022
220044000000111004444004444001110444444404422
220044000001110044444004444400111000044404422
220044000011100441111001111440011100044403322
220044000111004411111111111144001110000003322
220044001110044113131313131314400111000003322
220044011100441110011001110011440011100003322
220000001110044113131313331314400111000000022
220000000111004411111111111144001110000000022
221001100011100441001100111440011100444001122
224401100001110044444004444400111000444001122
224433304400111004444004444001110000333003322
221001104400011100003333300011100000333001122
221001104444001110000000000111000000333001122
220000004444000114444444444110000111111000022
220000000000000011111111111100000111111000022
220000000000000004444000444400000000000000022
224444404444444004444000444400000000000000022
224444404444444000004444400004444444044444022
224444404444444000004444400004444444044444022
221111101111111000000000000001111111011111022
221111101111111000044444440001111111011111022
220000000000000000011111110000000000000000022
221444411334411100011111110011144331111111122
221444411334433100011666110013344331111111122
223444411004411100011666110011144001144443322
223444411334411100011666110011144331144443322
222222222222222222222222222222222222222222222
222222222222222222222222222222222222222222222

