222222222222222222222222222222222222222222222
222222222222222222222222222222222222222222222
220000440000011104400000000440111000440000022
220000440000011104400000000440111000440000022
224444004444444440040044004004444444004444422
224444004444444440040044004004444444004444422
220011111111111111111444111111111111111110022
220011111111111111111444111111111111111110022
224411004444444004444444444400444444400114422
224411004400444004400444004400444004400114422
224411004400444004400444004400444004400114422
224411004400444004444444444400444004400114422
220011004400443333000111000333344004400110022
220440114400443333000111000333344004411044022
220440114444444444444111444444444444411044022
220000114444004004004111400400400444411000022
224444441144004004004111400400400441144444422
220044441144444004444111444400444441144440022
220040041144444004444111444400444441140040022
224440040011000001111111111100000110040044422
224444440011044111111111111111440110044444422
220044000011044444444444444444440110000440022
220044004400114444003333300444411004400440022
220044004400114004003111300400411004400440022
220044000000114004003111300400411000000440022
220044333344004004003111300400400443333440022
224444333344004004003333300400400443333444422
220044000004404444444444444444404400000440022
220044000004404444011111110444404400000440022
221111111111111111111111111111111111111111122
221111111111111111111111111111111111111111122
220004400033334404444000444404433330004400022
220004400033334404444000444404433330004400022
220000000044444444011111110004444440000000022
224440044444444444011111114404444444440044422
224440044433334400011666114404433334440044422
224440044433334400011666114404433334440044422
224440044400004400011666114404400004440044422
222222222222222222222222222222222222222222222
222222222222222222222222222222222222222222222
