222222222222222222222222222222222222222222222
222222222222222222222222222222222222222222222
220000440000011104400000000440111000440000022
220000440000011104400000000440111000440000022
224444004440044440040044004004400444004444422
224444004440044440040044004004400444004444422
220011111111111111111444111111111111111110022
220011111111111111111000111111111111111110022
224411004444400004444000444400004444400114422
224411004400400004400444004400004000000114422
224411000000444004400444004400444000000114422
224411000000444004444444444400444004400114422
220011004400443333000111000333344004400110022
220440114400443333000111000333344004411044022
220440110044444444444111444444444440011044022
220000110044004004004111400400400440011000022
224444441144004004004111400400400441144444422
220044441140044004400000440000440041144440022
220040041140044004400000440000440041140040022
224440040011000001111111111100000110040044422
224400440011044111111111111111440110044004422
220044000011044444444444444444440110000440022
220044004400114004003333300400411004400440022
220000004400114004003010300400411004400000022
220044000000114004003101300400411000000440022
220000333344004004003010300400400443333000022
224400333344004004003333300400400443333004422
220044000004404004400000004400404400000440022
220044000004404444011111110444404400000440022
221111111111111111111111111111111111111111122
221111111111111111111111111111111111111111122
220004400033334404444000444404433330004400022
220004400033334404444000444404433330004400022
220000000044400444011111110004004440000000022
224440044444400444011111114404004444440044422
220040044433334400011666114404433334440040022
220040000433334400011666114404433334000040022
224440000400004400011666114404400004000044422
222222222222222222222222222222222222222222222
222222222222222222222222222222222222222222222
