2222222222222222222222222222222222222222222222222222222222
2222222222222222222222222222222222222222222222222222222222
2200000000000000000000000000000000000000000001444100000022
2200000000000000000000000111111110000000000001444100000022
2211100000000000000000011111111111100000000001444100000022
2211101000000000000000111111111111110000000001444100000022
2200000100000000000001111111111111111000000001444100000022
2200001100000000000011111111111111111100000001111100000022
2200011110000000000011111111111111111100000000000000000022
2200013310000000000111111111111111111110000000000000000022
2200013310000000000111133311111133311110000001000000000022
2200011110000000000111133311111133311110000010000000000022
2200000000000000000111133311111133311110000011000000000022
2200000044444400000111111111111111111110000111100004444422
2200000044444400000111111111111111111110000133100004444422
2200000044334400000111111111111111111110000133100004444422
2200000044444400000111111111331111111110000111100003333322
2200000044444400000011111113333111111100000000000000000022
2200000001111111100000111111111111110000011111111000000022
2200000000111111110000111111111111110000111111110000000022
2200000000001111111100013131313131100011111111000000000022
2200000000000011111111000313131310001111111100000000000022
2244400000001000111111110001111000111111110000000001000022
2244400000010000001111111100000011111111000000000000100022
2244400000011000000011111111001111111100000000000001100022
2244400000111100000000111111111111110000000000000011110022
2244400000133100000000001111111111000000000000000013310022
2244400000133100000000001111111111000000000000000013310022
2211111000111100000000111111111111110000000000000011110022
2211111000000000000011111111001111111100000000000000000022
2200000000000000001111111100000011111111000000000000000022
2200000000000000111111110000000000111111110000000000000022
2200000000000011111111000000000000001111111100000000000022
2200000000001111111100000000000000000011111111000000000022
2200000000111111110000000000000000000000111111110000000022
2200000001111111100000000000000000000000011111111000000022
2200001000000000000000000000000000000000000000000000000022
2200010000000000000000000000000000000000000000000000000022
2200011000000000000000000111111110000000000000000000000022
2200111100000044440000000111111110000000000000000000000022
2200133100000044440000000116666110000000000000000000000022
2200133100000044440000000116666110000000000044444300000022
2200111100000044440000000116666110000000000044444300000022
2200000000000044440000000116666110000000000044444300000022
2222222222222222222222222222222222222222222222222222222222
2222222222222222222222222222222222222222222222222222222222
